21/11
0/6
10/5
.....############....
.....#..........#....
.....##########.####.
..............#....#.
.....####.....#.####.
.....#..#.....#.#....
S#####..#######.#....
................#....
.....############....
.....#...............
.....E...............
EEEEENNEEESSEEEEEENNNNWWWWWWWWWNNEEEEEEEEEEESSEEESSWWWSSSSWWWWWWWWWWWSS